(C)	S IY
(FIXED)	F IH K S T
-0.2218	
-0.3010	
-0.7782	
-1.5563	
-2.0334	
0.0000	Z IY R OW Z IY R OW Z IY R OW Z IY R OW Z IY R OW
0.5.	Z IY R OW F AY V
14:21:33	W AH N F OW R T UW W AH N TH R IY TH R IY
18	W AH N EY T
1996-2010	W AH N AY N AY N S IH K S T UW Z IY R OW W AH N Z IY R OW
1=20	W AH N T UW Z IY R OW
20	T UW Z IY R OW
2013	T UW Z IY R OW W AH N TH R IY
2=36	T UW TH R IY S IH K S
3=18	TH R IY W AH N EY T
4	F OW R
</S>	EH S
<S>	EH S
A	AH
A(2)	EY
ALEXANDER	AE L IH G Z AE N D ER
AND	AH N D
AND(2)	AE N D
ARE	AA R
ARE(2)	ER
ARPA	AA R P AH
AT	AE T
AVAILABLE	AH V EY L AH B AH L
BACKOFFS	B AE K AO F S
BASED	B EY S T
BE	B IY
BEING	B IY IH NG
BUT	B AH T
BY	B AY
CARNEGIE	K AA R N EH G IY
CARNEGIE(2)	K AA R N EY G IY
CODE	K OW D
COMPUTED	K AH M P Y UW T AH D
COMPUTED(2)	K AH M P Y UW T IH D
COPYRIGHT	K AA P IY R AY T
CORPUS	K AO R P AH S
CREATED	K R IY EY T AH D
CREATED(2)	K R IY EY T IH D
DESIGNED	D IH Z AY N D
DID	D IH D
DISCOUNT	D IH S K AW N T
DOUG	D AH G
EDT	EH D T
FIRST	F ER S T
FOR	F AO R
FOR(2)	F ER
FOR(3)	F R ER
FORMAT,	F AO R M AE T
HE	HH IY
HTTP://WWW.SPEECH.CS.CMU.EDU/TOOLS/	HH T P W S P IY CH K S K M UW EH D UW T UW L Z
I.	AY
IN	IH N
INFORMATION	IH N F AO R M EY SH AH N
IS	IH Z
IT	IH T
JARVIS	JH AA R V AH S
JARVIS(2)	JH AA R V IH S
LANGUAGE	L AE NG G W AH JH
LANGUAGE(2)	L AE NG G W IH JH
MASS	M AE S
MELLON	M EH L AH N
METHOD.	M EH TH AH D
MITRE.	M AY T ER
MODEL	M AA D AH L
MORE	M AO R
NGRAM	N G R AE M
NOW	N AW
OF	AH V
ON	AA N
ON(2)	AO N
OPEN	OW P AH N
PAUL	P AO L
PLEASE	P L IY Z
PRODUCE	P R AH D UW S
PRODUCE(2)	P R OW D UW S
QUICKLM	K W IH K L M
RATIO	R EY SH IY OW
RIGHT	R AY T
RUDNICKY	R AH D N IH K IY
SAY	S EY
SENTENCES	S EH N T AH N S AH Z
SENTENCES(2)	S EH N T AH N S IH Z
SEP	S EH P
SEP(2)	EH S IY P IY
SOURCE.	S OW R S
STANDARD	S T AE N D ER D
THAT	DH AE T
THAT(2)	DH AH T
THE	DH AH
THE(2)	DH IY
THIS	DH IH S
TO	T UW
TO(2)	T IH
TO(3)	T AH
UNIVERSITY	Y UW N AH V ER S AH T IY
USED	Y UW Z D
USING	Y UW Z IH NG
VISIT	V IH Z IH T
WAS	W AA Z
WED	W EH D
WHAT	W AH T
WHAT(2)	HH W AH T
WHICH	W IH CH
WHICH(2)	HH W IH CH
WHILE	W AY L
WHILE(2)	HH W AY L
WITH	W IH DH
WITH(2)	W IH TH
WORDS	W ER D Z
WORK	W ER K
\1-GRAMS:	W AH N G R AE M Z
\2-GRAMS:	T UW G R AE M Z
\3-GRAMS:	TH R IY G R AE M Z
\DATA\	D EY T AH
\END\	EH N D